аккуратный - неряшливый 
антоним - синоним 
белый - черный 
бледнеть - краснеть, темнеть 
блестеть - мерцать, тускнеть 
близкий - далекий 
богач - бедняк 
большой - маленький 
быстрый - медленный 
век - мгновение 
верный - ошибочный 
веселый - грустный, печальный, скучный 
ветреный - безветренный
ветхий - новый 
включить - выключить
внутри - снаружи
вопрос - ответ
восток - запад, вест(мор) 
восход - закат 
входить - выходить
высокий - низкий 
гасить - зажигать 
гладкий - шершавый 
гласный - согласный 
глубокий - мелкий 
говорить - молчать
голодный - сытый
город - село, деревня 
горький - сладкий 
горячий - холодный 
греть - охлаждать 
грязь - чистота 
грязный - чистый
делать - бездельничать 
день - ночь 
диалог - монолог 
добро - зло 
друг - враг 
дюжий - хилый
ехать - останавливаться
жара - холод 
жёсткий - мягкий 
замкнутый - общительный 
здоровый - больной 
зелёный - зрелый, спелый 
зима - лето 
искренний - лицемерный 
истина - заблуждение, обман 
исток - устье 
крепкий - непрочный
кислый - сладкий
лентяй - труженик 
лишний - необходимый 
ловкий - неуклюжий 
ложиться - вставать 
любить - ненавидеть 
мёрзнуть - согреваться 
мир - война, ссора
много - мало
могучий - слабый 
мокрый - сухой 
мудрый - глупый
мягкий - твердый
надежда - отчаяние 
нарочный - нечаянный 
невозмутимый - неуравновешенный 
немудрёный - зымысловатый
новый - старый 
обильный - скудный
оборонять - нападать 
образованный - невежественный 
огорчить - утешить 
острый - тупой 
отважный - трусливый, малодушный 
откровенный - скрытный
открыть - закрыть
очевидный - сомнительный 
плюс - минус
победа - поражение
повесить - снять
полезный - вредный
положить - взять
польза - вред 
помогать - мешать 
правда - ложь 
правдивый - лживый 
привередливый - неприхотливый 
приятный - отталкивающий
пустой - полный
пушистый - гладкий
радость - грусть, печаль 
различие - сходство 
расторопный - медлительный 
решительный - неуверенный 
робкий - смелый 
Родина, отчизна - чужбина 
свет - тьма, темнота 
светать - смеркаться 
север - юг, зюйд(мор) 
смеяться - плакать 
спасти - погубить 
спать - бодрствовать
старт - финиш
сытый - голодный
твердый - мягкий
темный - светлый
тесный - просторный 
толстый - тонкий 
тонкий - толстый
труд - отдых
трудный - легкий 
тужить - радоваться 
уверить - разубедить 
угрюмый - приветливый 
удаляться - приближаться
узкий - широкий  
умышленный - нечаянный
упрямый - покладистый 
успех - неудача 
участливый - равнодушный 
халатный - добросовестный 
храбрый - трусливый 
частый - редкий 
честный - подлый 
широкий - узкий 
щедрый - скупой